############
#          #
####### ####
#          #
## #########
#          O
############
